20
18
22 4 0 0 0 0 0 0 0 0 0 0 0 0 0 0 0 0 0 22
22 4 0 0 0 0 0 0 0 0 0 0 0 0 0 0 0 0 0 22
22 4 0 0 0 0 0 0 0 0 0 0 0 0 0 0 0 0 0 22
22 4 0 0 0 0 0 0 0 0 0 0 0 0 0 0 0 0 0 22
22 4 0 0 0 0 0 0 0 0 0 0 0 0 0 0 0 0 0 22
22 4 0 0 0 0 0 0 0 0 0 0 0 0 0 0 0 0 0 22
22 4 0 0 0 0 0 0 0 0 0 0 0 0 0 0 0 0 0 22
22 4 0 0 0 0 0 0 0 0 0 0 0 0 0 0 0 0 0 22
22 4 0 0 0 0 21 21 21 21 21 21 21 21 0 0 0 0 3 22 
22 4 0 0 0 0 0 0 0 0 0 0 0 0 0 0 0 0 3 22
22 21 21 23 0 0 22 0 0 22 22 0 0 22 0 0 22 21 21 22 
22 4 0 0 0 0 0 0 0 0 0 0 0 0 0 0 0 0 0 22 
22 4 0 0 0 0 21 21 21 21 21 21 21 21 0 0 0 0 3 22
22 4 0 0 0 0 0 0 0 0 0 0 0 0 0 0 0 0 3 22 
22 21 21 23 0 0 0 0 0 0 0 0 0 0 0 0 22 21 21 22 
22 4 0 0 0 0 22 23 0 22 22 0 22 23 0 0 0 0 3 22 
22 4 0 0 0 0 0 0 0 0 0 0 0 0 0 0 0 0 3 22 
5 21 21 21 21 21 21 21 21 21 21 21 21 21 21 21 21 21 21 22